10 Fruits Jungle Slider = 10 Früchte Urwaldrutsche
1st District = Traverse Mitte
2nd District = Traverse Nord
42 Puppies = 42 Welpen
Jungle Slider = Urwaldrutsche
51 Puppies = 51 Welpen
60 Puppies = 60 Welpen
72 Puppies = 72 Welpen
90 Puppies = 90 Welpen
Ability Stud  = Fleißring
Accessory Shop = Accessoire-Laden
Adamant Shield = Adaman-Schild
Aerith TT = Aerith ST
Aero Arts = Aero-Meister
Aero Magic = Aero-Magie
Aeroga Magic = Aeroga-Magie
Aerora Magic = Aerora-Magie
Agrabah = Agrabah
Agrabah: Alley = Lagerhof
Agrabah: Bazaar = Hinterhof
Agrabah: Main Street = Hauptstraße
Agrabah: Plaza = Stadtportal
Agrabah: Storage = Warenlager
Aladdin's House = Aladdins Haus
All Spells = Alle Zauber
All Summons = Alle Beschwörungen
Alleyway = Hintergasse
Angel Bangle = Engelsreif
Ansem's Report 1 = Ansem's Bericht 1
Ansem's Report 10 = Ansem's Bericht 10
Ansem's Report 11 = Ansem's Bericht 11
Ansem's Report 12 = Ansem's Bericht 12
Ansem's Report 13 = Ansem's Bericht 13
Ansem's Report 2 = Ansem's Bericht 2
Ansem's Report 3 = Ansem's Bericht 3
Ansem's Report 4 = Ansem's Bericht 4
Ansem's Report 5 = Ansem's Bericht 5
Ansem's Report 6 = Ansem's Bericht 6
Ansem's Report 7 = Ansem's Bericht 7
Ansem's Report 8 = Ansem's Bericht 8
Ansem's Report 9 = Ansem's Bericht 9
Antenna = Stachel
AP Up = Abilitamin
Ars Arcanum = Tollwut
Arts = Meistertitel
Atlantica = Atlantica
Atlas Armlet = Dalfgan-Ring
Azal Vol. 3 = Azas Glück, Bd. 3
Bambi = Bambi
Base Level = Unterbau
Behemoth = Behemoth
Belle in HB2 = Belle in HB2
Bizarre Room = Wunderzimmer
Blaze Gem = Pyropstein
Blaze Shard = Pyropsplitter
Blazing Stone = Pyroptropfen
Blizzaga Magic = Eisga-Magie
Blizzaga Ring = Eisga-Ring
Blizzagun Band = Eisgan-Armreif
Blizzara Magic = Eisra-Magie
Blizzara Ring = Eisra-Ring
Blizzard Arts = Eis-Meister
Blizzard Magic = Eis-Magie
Blizzard Ring = Eis-Ring
Blue Trinity = Blaues Trio-Tech
Boneyard = Totengruft
Bottomless Hall = Raum der Tiefe
Brave Warrior = Narchia-Reif
Bridge = An der Steinbrücke
Bright Crystal = Lunakristall
Bright Gem = Lunastein
Bright Shard = Lunasplitter
Camp = Zeltlager
Camp: Tent = Zelt
Camping Set = Camping Set
Capt. Hook = Käpt'n Hook
Captain's Cabin = Kapitänskajüte
Castle Gates = Eingangsportal
Cave: Entrance = Höhlen-Eingang
Cave: Hall = Halle der Speier
Cavern of Hearts = Herzenshöhle
Cemetery = Totengruft
Cerberus = Kerberus
Chamber 3 = Bauch 3
Chamber 5 = Bauch 5
Chamber 6 = Bauch 6
Chaos Ring = Chaosring
Cheer (Donald) = Schamane (Donald
Cheer (Goofy) = Schamane (Goofy)
Cheer (Sora) = Schamane (Sora)
Chernabog = Chernabog
became = wurde zu
Chest at = Truhe bei
Chest = Truhe
Claw Marks = Kralle
Claws = Klaue
Climbing Trees = Mammutbaum
Clock Tower = Glockenturm
Cloth = Großes Laken
Cloud Hercules Cup = Cloud Hercules-Cup
Coconut = Kokos-Frucht
Coliseum Gates = Heroen-Platz
Combo Plus = Combo+
Cosmic Arts = Kosmische Künste
Cottage = Hütte
Crabclaw = Maritim
Critical Plus = Volltreffer+
Crystal Crown = Kristallmitra
Crystal Trident = Meereskristall
Cura Magic = Vitra-Magie
Curaga Magic = Vigra-Magie
Cure Arts = Vita-Meister
Cure Magic = Vita-Magie
Dalmatians = Dalmatiner
Dalmatians' Hous = Haus der Dalmatiner
Dark Chamber = Ort der Schatten
Dark Matter = Dunkelmaterie
Dark Ring = Dunkelring
Day1 = Tag 1
Dazzling Stone = Juwelentropfen
Deep Jungle = Tiefer Dschungel
Defeat Leon = Besiege Leon
Defender = Defendor-Schild
Defense Up = Schutzengel
Destiny Islands = Inseln des Schicksals
Destiny Islands = Inseln des Schicksals
Diamond Dust = Diamantenstaub
Divine Rose = Zentifol
Dodgeroll = Ausweichrolle
Dragon Maleficent = Drachen-Malefiz
Dream Rod (Donald) = Alchera-Stab (Donald)
Dream Rod = Alchera-Stab
Dream Shield (Goofy) = Alchera-Schild (Goofy)
Dream Shield = Alchera-Schild
Dream Sword = Alchera-Schwert
Drill-G = Bohrer-Gumi
Drinking Water  = Trinkwasser
Dumbo = Dumbo
Dungeon = Kerker
Earthshine = Enigmanith
Element Ring = Elementring
Elixir = Elixier
Emblem Piece (Chest) = Emblemsplitter (Truhe)
Emblem Piece (Flame) = Emblemsplitter (Flamme)
Emblem Piece (Fountain) = Emblemsplitter (Brunnen)
Emblem Piece (Statue) = Emblemsplitter (Statue)
Empty Bottle = Leere Flasche
End of TT = Ende von TT
Energy Bangle = Energiereif
Energy Stone = Energietropfen
Entrance Hall = Wandelhalle
Entry Pass = Eintrittskarte
Ether = Äther
Evidence = Beweise
EXP Bracelet = Armband
EXP Earring = EXP-Ohrring
EXP Necklace = EXP-Kette
EXP Ring = EXP-Ring
Fairy Godmother = Die Gute Fee
Fairy Harp = Feenharfe
Fantasista = Fantasista
Final Dimension = Firmament des Bösen
Final Rest = Letzter Ruherort
Fira Magic = Feura-Magie
Fira Ring = Feura-Ring
Fira-G = Feura-Gumi
Firaga Magic = Feuga-Magie
Firaga Ring = Feuga-Ring
Firagun Band = Feugan-Armreif
Fire Arts = Feuer-Meister
Fire Magic = Feuer-Magie
Fire Ring = Feuer-Ring
Fireglow = Feueropal
Fish = Meeresfisch
Flare-G = Flare-Gumi
Footprints = Fußspuren
Forget-Me-Not = Vergissmeinnicht
From Owl = Von Eule
Frost Gem = Cyanitstein
Frost Shard = Cyanitsplitter
Frost Stone = Cyanittropfen
Full-Life-G = Erzengel-Gumi
Fury Stone = Wuttropfen
Gaia Bangle = Gaia-Reif
Gale = Sturmkristall
Genie = Dschinni
Genji Shield = Genji-Schild
Gepetto's House = Geppettos Haus
Giant Crevasse = Firn des Bösen
Gigas Fist = Gigas-Buckler
Golem Chain = Kämpferkette
Golem Shield = Golem-Schild
Grand Hall = 6-Lichterhalle
Grand Mallet = Richtstab
Graviga Magic = Graviga-Magie
Gravira Magic = Gravitra-Magie
Gravity Arts = Gravi-Meister
Gravity Break = Gravitas-Brecher
Gravity Magic = Gravitas-Magie
Great Crest = Außenwand der Gewinde
Green Room = Zimmer Waldrian
Green Trinity = Grünes Trio-Tech
Guard Armor = Panzerrüstor
Guard Earring = Eiferring
Guillotine Square = Fallbeil-Platz
Gummi = Gumi
Hades Cup = Hades-Cup
Hades Cup Solo = Hades-Cup Solo
Hades Cup Time Trial = Hades-Cup (Gegen die Zeit)
Hafet Vol. 4 = Weißmagie, Bd. 4
Halloween Town = Halloween Town
Haste2-G = Hastga-Gumi
Heartguard = Kardia-Wache
Herc's Shield = Hercules-Schild
Hercules Cup Solo = (Hercules-Cup Solo
Hercules Cup Time Trial = Hercules Cup (Gegen die Zeit)
Hero License = Heldenlizenz
Hidden Room = Ort der Scheue
High Jump = Sportsfreund
Glide = Gleiter
High Tower = Erker der Schlote
Hi-Potion = Hi-Potion
Hippos' Lagoon = Nilpferdtümpel
Holy Circlet = Heiligenring
Holy-G = Sanctus-Gumi
Hook = Hook
Hundred Acre Wood = 100-Morgen-Wald
Ice Titan = Polaros
Ifrit Belt = Ifrit-Gürtel
Ifrit's Horn = Flammenwall
Inferno Band = Inferno-Wall
Item Workshop = Item-Laden
Jack-In-The-Box = Überaschung
Jungle King = Simplexus
Jungle: Cliff = Felsklippe
Jungle: Tunnel = Totenbaum
Jungle: Vines = Tiefer Urwald
Jungle: Vines 2 = Dschungel-Eingang
Kairi TT4 = Kairi TT4
Khama = Karma
Khama Vol. 8 = Karma, Bd. 8
Kingdom Key = Königsanhänger
Knight's Shield = Ritterschild
Kurt Zisa = Kurt Zisa
Lady Luck = Herzensbrecher
Leon & Cloud Hades Cup = Leon & Cloud Hades-Cup
Library = Bibliothek
Life-G = Engel-Gumi
Lift Stop = Liftschacht
Lightning Stone = Donnerquarz
Lionheart = Löwenherz
Log = Baumstamm
Lord Fortune = Galaxithen-Stab
Lotus Forest = Lotus-Hain
Lucid Crystal = Luzidkristall
Lucid Gem = Luzidstein
Lucid Shard = Luzidsplitter
Mage's Staff = Zauberstab
Magic Armlet = Zauberring
Magus Staff = Magier-Stab
Maleficent = Malefiz
Master Earring = Meisterring
Matsutake Rank = Koryphäe (Rarfungi)
Mava Vol. 3 = Ilis Tod, Bd. 3
Mava Vol. 6 = Ilis Tod, Bd, 6
Max Spells = Max. Zauber
Mega Potion = Mega-Potion
Mega-Ether = Mega-Äther
Megalixir = Final-Elixier
Merlin = Merlin
Mermaid Kick = Nixenflosse
Metal Chocobo = Chocobo
Meteor Strike = Meteo-Stab
Meteor-G = Meteo-Gumi
Mighty Shield = Mächtiger Schild
Missable = Verpassbar
Monstro: Mouth = Rachen
Moogle Badge = Mogry-Abzeichen
Moonlight Hill = Mondscheinhügel
Morning Star = Sternenstab
Mushroom = Pilz
Mushu = Mushu
Mystery Goo = Freudentau
Mystery Mold = Fundsache?
Mystical House = Zauberhaftes Haus
Mythril = Mithril
Mythril Shard = Mithril-Erz
Mythril Shield  = Mithril-Schild
Mythril Stone = Mithriltropfen
Nahara Vol. 5 = Druiden, Bd. 5
Naturespark = Amethyst
Navi-G Piece 1 = Navi-Gumini 1
Navi-G Piece 2 = Navi-Gumini 2
Navi-G Piece 3 = Navi-Gumini 3
Navi-G Piece 4 = Navi-Gumini 4
Navi-Gummi = Navi-Gumi
Navi-Gummi Unused = Navi-Gumi (Unbenutzt)
Neverland = Nimmerland
No Weapon = Unbewaffnet
Oathkeeper = Sternentreue
Oblivion = Memoire
Obsidian Ring = Obsidian-Ring
Old Book = Antikes Buch
Olympia = Heros
Olympus Coliseum = Arena des Olymp
Omega Arts = Omegadot
One-Winged Angel = Einflügliger Engel
Onyx Shield = Platin-Schild
Oogie = Oogie
Oogie Boogie = Oogie Boogie
Oogie Manor = Oogie Boogies Gut
Orichalcum = Orihalcon
Osmose-G = Spirit-Gumi
Page1 = Verlorene Seite 1
Page2 = Verlorene Seite 2
Page4 = Verlorene Seite 4
Page5 = Verlorene Seite 5
Palace Gates = Lagerhof
Paper-G = Papier-Gumi
Parasite Cage = Parasitakel
Pegasus Cup Solo = Pegasus-Cup Solo
Pegasus Cup Time Trial = Pegasus-Cup (Gegen die Zeit)
Phil Cup Solo = Phil-Cup Solo
Phil Cup Time Trial = Phil-Cup (Gegen die Zeit)
Pirate Ship = Hooks Piratenschiff
Postcard = Postkarte
Postcard 1 = Postkarte 1
Postcard 10 = Postkarte 10
Postcard 2 = Postkarte 2
Postcard 3 = Postkarte 3
Postcard 4 = Postkarte 4
Postcard 5 = Postkarte 5
Postcard 6 = Postkarte 6
Postcard 7 = Postkarte 7
Postcard 8 = Postkarte 8
Postcard 9 = Postkarte 9
Pot Centipede = Arachnovita
Potion = Potion
Power Chain = Kraftkette
Power Crystal = Achatnith
Power Gem = Achatstein
Power Shard = Achatsplitter
Power Stone = Achattropfen
Power Up = Kraftbolzen
Pretty Stone = Diamant
Prime Cap = Premium-Kappe
Protect Chain = Protes-Kette
Protega Chain = Protega-Kette
Protera Chain = Protera-Kette
Pumpkinhead = Cucurbita
Queen's Castle = Herztrinumal
Rabbit hole = Kaninchenbau
Ragnarok = Ragnarök
Ramuh Belt = Ramuh-Gürtel
Raven's Claw = Zierrat-Kralle
Ray of Light = Girlande
Red Room = Zimmer Feurio
Red Trinity = Rotes Trio-Tech
Relic Chamber = Ort der Relikte
Reward = Belohnung
Ribbon = Schleife
Riku 2 = Riku 2
Rising Falls = Kaskade der Irre
Rope = Seil
Royal Crown = Königliche Krone
Rune Armlet = Runenreif
Sabor 2 = Sabor 2
Salegg Vol. 6 = Troll, Bd. 6
Save the King = Königswache
Save the Queen = Infantin-Wache
Scan-G = Analyse-Gumi
Scissors-G = Schere-Gumi
Seagull Egg = Papadu-Ei
Second Wind = Frohnatur
Secret Waterway = Geheimer Wasserkanal
Sephiroth = Sephiroth
Serenity Power = Freudenstein
Seven Elements = Sieben Elemente
Shiitank Rank = Experte (Rarfungi)
Shiny Crystal = Orkuskristall
Ship: Cabin = Kabine
Ship: Galley = Kombüse
Ship: Hold = Lagerraum
Shiva Belt = Shiva-Gürtel
Shooting Star = Penta-Stab
Silent Chamber = Ort der Stille
Silver Mallet = Hammerstab
Simba = Simba
Slide 1 = Dia 1
Slide 2 = Dia 2
Slide 3 = Dia 3
Slide 4 = Dia 4
Slide 5 = Dia 5
Slide 6 = Dia 6
Slides = Dias
Smasher = Buckler
Sonic Blade = Perforieren
Spear = Speer
Spellbinder = Examinator
Spirit Gem = Rubinstein
Spirit Shard = Rubinsplitter
Stench = Geruch
Stop Arts = Stop-Meister
Stop Magic = Stop-Magie
Stopga Magic = Stopga-Magie
Stopra Magic = Stopra-Magie
Stormy Stone = Sturmtropfen
Stout Shield = Dreiecksschild
Strike Raid = Tontaube
Superglide = Paragleiter
Dodge Roll = Purzelbaum
Tea Party Garden = Teeparty-Garten
Tech Boost = Tech-Boost
Tent = Zelt
Theon Vol. 6 = Zons Opus, Bd. 6
Three Stars = Dreigestirn
Three Wishes = Wunderlampe
Thundaga Magic = Blitzga-Magie
Thundaga Ring = Blitzga-Ring
Thundaga-G = Blitzga-Gumi
Thundagun Band = Blitzgan-Armreif
Thundara Magic = Blitzra-Magie
Thundara Ring = Blitzra-Ring
Thundara-G = Blitzra-Gumi
Thunder Arts = Blitz-Meister
Thunder Gem = Donnerstein
Thunder Magic = Blitz-Magie
Thunder Ring  = Blitz-Ring
Thunder Shard = Donnersplitter
Tinker Bell = Naseweis
Titan Chain = Kriegerkette
Torn Page 1 = Verlorene Seite 1
Torn Page 2 = Verlorene Seite 2
Torn Page 3 = Verlorene Seite 3
Torn Page 4 = Verlorene Seite 4
Torn Page 5 = Verlorene Seite 5
Traverse Town = Stadt Traverse
Treasure Magned = Charmeur
Treasure Room = Schatzkammer
Tree House = Baumhaus
Trickmaster = Stelzenknüppler
Trinity Limit = Trio-Gramm
Ultima Weapon = Ultima
Ultima-G = Ultima-Gumi
Unknown = Der Unbekannte
Unused (Goofy) = Unbenutzt (Goofy)
Ursula = Ursula
Violetta = Thanatos-Stab
Warhammer = Kampfstab
Waterfall Cavern = Hinter dem Wasserfall
Watergleam = Aquamarium
Waterway = Untergrundkanal
White Fang = Reißzahn
White Trinity = Weißes Trio-Tech
Wisdom Staff = Weisheitsstab
Wishing Star = Wunschgestirn
Wizard's Relic = Großmagierstab
Wonderland = Wunderland
Wooden Sword = Holzschwert
World Terminus = Weltenkarzer
Yellow Trinity = Gelbes Trio-Tech
Yuffie Hades Cup = Yuffie-Hades-Cup
Zantetsuken = Zantetsuken
