Destiny Islands = Islas del Destino	
Traverse Town = Ciudad de Paso
1st District = Distrito 1
2nd District = Distrito 2
Alleyway = Callejon
Green Room = Habitacion verde
Red Room = Habitacion roja
Mystical House = Casa misteriosa
Accessory Shop = Tienda de accesorios
Secret Waterway = Canal oculto
Gepetto's House = Casa de Geppetto
Item Workshop = Tienda de objetos
Dalmatians' House = Casa de los dalmatas
Magician's Study = Estudio del mago
Postcard 1 = Tarjeta Postal 1
Postcard 2 = Tarjeta Postal 2
Postcard 3 = Tarjeta Postal 3
Postcard 4 = Tarjeta Postal 4
Postcard 5 = Tarjeta Postal 5
Postcard 6 = Tarjeta Postal 6
Postcard 7 = Tarjeta Postal 7
Postcard 8 = Tarjeta Postal 8
Postcard 9 = Tarjeta Postal 9
Postcard 10 = Tarjeta Postal 10
Guard Armor = Armadura
Merlin = Merlin
Kairi TT4 = Kairi CdP 4
End of TT = Fin de CdP
Defeat Leon = Derrota a Leon
Aerith TT = Aeris CdP
Fairy Godmother = Hada madrina
Wonderland = Pais de las maravillas
Rabbit Hole = Madriguera
Bizarre Room = Cuarto misterioso
Lotus Forest = Bosque de lotos
Queen's Castle = Palacio real
Tea Party Garden = Jardin del te
Trickmaster = Prestidigitador
Olympus Coliseum = Coliseo del Olimpo
Coliseum Gates = Entrada al coliseo
Lobby = Portal
Phil Cup = Copa Fil
Phil Cup Solo = Copa Fil Sora solo
Phil Cup Time Trial = Copa Fil cronometrada
Pegasus Cup = Copa Pegaso
Pegasus Cup Solo = Copa Pegaso Sora solo
Pegasus Cup Time Trial = Copa Pegaso cronometrada
Cloud Hercules Cup = Copa Hercules Cloud
Hercules Cup = Copa Hercules
Hercules Cup Solo = Copa Hercules Sora solo
Hercules Cup Time Trial = Copa Hercules cronometrada
Yuffie Hades Cup = Copa Hades Yuffie
Leon & Cloud Hades Cup = Copa Hades Leon y Cloud
Hades Cup = Copa Hades
Hades Cup Solo = Copa Hades Sora solo
Hades Cup Time Trial = Copa Hades cronometrada
Ice Titan = Titan de hielo
Sephiroth = Sefirot
Cerberus = Cerbero
Deep Jungle = Selva Profunda
Camp = Campamento Fuera
Camp: Tent = Campamento Dentro
Climbing Trees = Gran arbol del interior
Hippos' Lagoon = Hipopotamos
Jungle: Tunnel = Gran Foso
Jungle: Vines = Bosque viejo	
Jungle: Vines 2 = Entrada de la selva
Waterfall Cavern = Detras de la cascada
Cavern of Hearts = Cueva del corazon
10 Fruits Jungle Slider = 10 Frutas Tobogan selvatico
Jungle Slider = Tobogan selvatico
Sabor 2 = Sabor 2
Jungle: Cliff = Pared rocosa
Tree House = Nivel superior
Agrabah = Agrabah
Agrabah: Alley = Callejon
Agrabah: Bazaar = Bazarr
Agrabah: Main Street = Calle principal
Agrabah: Plaza = Plaza del palacio
Agrabah: Storage = Almacen
Aladdin's House = Casa de Aladdin
Palace Gates = Puertas del palacio
Cave: Entrance = Cueva: Entrada
Cave: Hall = Cueva: Sala principal
Bottomless Hall = Cueva: Sala del foso
Dark Chamber = Sala oscura
Silent Chamber = Sala silenciosa
Relic Chamber = Sala de la reliquia
Hidden Room = Sala oculta
Treasure Room = Sala del tesoro
Pot Centipede = Ciempies
Kurt Zisa = Kurt Zisa
Halloween Town = Ciudad de Halloween
Guillotine Square = Plaza de la guillotina
Graveyard = Cementerio
Boneyard = Cementerio publico
Moonlight Hill = Colina de la Luna
Bridge = Puente colgante
Oogie Manor = Mansion de Oogie
Cemetery = Cementerio publico
Oogie Boogie = Oogie Boogie
Monstro = Monstruo
Monstro: Mouth = Monstruo : Boca
Chamber 2 = Estomago 2
Chamber 3 = Estomago 3
Chamber 5 = Estomago 4
Chamber 6 = Estomago 5
Parasite Cage = Jaula Parasita
Neverland = Nunca jamas
Ship: Galley = Cocina
Ship: Hold = Barco pirata : Bodega
Ship: Cabin = Camarote
Captain's Cabin = Camarote del capitan
Clock Tower = Torre del reloj
Pirate Ship = Barco pirata
Anti-Sora = Anti Sora
Capt. Hook = Capitan Garfio
Hollow Bastion = Bastion Hueco
Rising Falls = Aguas trepadoras
Castle Gates = Entrada principal
Base Level = Nivel inferior
Waterway = Acueducto
Dungeon = Mazmorra
Entrance Hall = Vestibulo
Library = Biblioteca
Lift Stop = Parada de telefericos
Great Crest = Muro del emblema
High Tower = Torre
Grand Hall = Gran Salon
Maleficent = Malefica
Dragon Maleficent =  Malefica Dragon
Riku 2 = Riku 2
Belle in HB2 = Bella en BH2
Behemoth = Begimo
Unknown = Desconocido
End of the World = Fin del mundo
Final Dimension = Espacio infinito
Giant Crevasse = Gran grieta
World Terminus = Mundos cautivos
Final Rest = Descanso final
Chernabog = Chernabog
Hundred Acre Woods = Bosque de los cien acres
From Owl = De buho
Jungle King = Artesana
Olympia = Heroica
Three Wishes = Tres deseos
Pumpkinhead = Calabaza macabra
Crabclaw = Joya del mar
Fairy Harp = Arpa de hada
Lionheart = Lionheart
Diamond Dust = Polvo de diamante
One-Winged Angel = Fulgor serafico
Spellbinder = Examinadora
Dream Rod = Baston de ensueño
Dream Shield = Escudo de ensueño
Oathkeeper = Prometida
Divine Rose = La rosa
Metal Chocobo = Acero chocobo
Ray of Light = Rayo de luz
White Fang = Colmillo salvaje
Holy Circlet = Orbe sagrado
EXP Necklace = Arete de exp
EXP Ring = Anillo de exp
Omega Arts = Caliz omega
Raven's Claw = Uña de cuervo
Inferno Band = Pulsera infernal
Brave Warrior = Bravo guerrero
Ifrit's Horn = Cuerno de ifrit
Zantetsuken = Zantetsuken
Ars Arcanum = Arte arcano
Sonic Blade = Estocada rapida
Trinity Limit = Trio implacable
Strike Raid = Tiro mortifero
Combo Plus = Combo+1
Ragnarok = Ragnarok
Gravity Break = Golpe de gravedad
Tech Boost = Extraordinario
Critical Plus = Mas letales
High Jump = Salto de altura
Glide = Planeador
Superglide = Superplaneador
Mermaid Kick = Estilo sirena
Dodge Roll = Voltereta
Dark Matter = Materia oscura
Mythril = Mitrilo
Orichalcum = Orichalcum
AP Up = Ph+1
Defense Up = Defensa+1 
Power Up = Fuerza+1
Elixir = Elixir
Megalixir = Omnielixir
Mega-Potion =  Omnipocion
Cottage = Chale
Mega-Ether = Omnieter
Mythril Shard = Trozo de mitrilo
Pretty Stone = Piedra bonita
Gale = Viento recio
Naturespark = Brillo de naturaleza
Watergleam = Brillo de agua
Earthshine = Brillo de tierra
Fireglow = Brillo de fuego
Tinker Bell = Campanilla
Genie = Genio
Cheer (Sora) = Pm invocacion (Sora)
Cheer (Donald) = Pm invocacion (Donald)
Cheer (Goofy) = Pm invocacion (Goofy)
Genji Shield = Escudo de Genji
Lord Fortune = Buena fortuna
Save the Queen = Viva la Reina
Save the King = Viva el Rey
Herc's Shield = Escudo de Hercules
Postcard = Tarjeta postal
Khama Vol. 8 = Khama vol. 8 
Theon Vol. 6 = Theon Vol. 6
Log = Tronco
Cloth = Paño
Rope = Cuerda
Seagull Egg = Huevo de cigüeña 
Mushroom = Champiñon
Coconut = Coco
Fish = Pez
Drinking Water = Agua potable
Emblem Piece (Flame) = Fragmento (Llama)
Emblem Piece (Fountain) = Fragmento (Fuente)
Emblem Piece (Chest) = Fragmento (Cofre)
Emblem Piece (Statue) = Fragmento (Estatua)
Navi-Gummi = Gumi guia
Torn Page 2 = Pagina arrancada 2
Torn Page 3 = Pagina arrancada 3
Jack-In-The-Box = Caja de sorpresas
Ansem's Report 3 = Informe de Ansem 3
Ansem's Report 7 = Informe de Ansem 7
Ansem's Report 9 = Informe de Ansem 9
Crystal Trident = Tridente de cristal
Forget-Me-Not = Nomeolvides
Slide 1 = Diapositiva 1
Slide 2 = Diapositiva 2
Slide 3 = Diapositiva 3
Slide 4 = Diapositiva 4
Slide 5 = Diapositiva 5
Slide 6 = Diapositiva 6
Footprints = Huella delatora
Claw Marks = Rasguño delator
Stench = Olor delator
Antenna = Espina delatora
Entry Pass = Pase
Hero License = Titulo de Heroe
Navi-G Piece 1 = Gumi Guia Pieza 1
Navi-G Piece 2 = Gumi Guia Pieza 2
Navi-G Piece 3 = Gumi Guia Pieza 3
Navi-G Piece 4 = Gumi Guia Pieza 4
Reward = Recompensa
Chest at = Cofre en
became = se convirtio